yuwei	余 伟
wangl	王 亮
chenzj	陈 志军
wangxq	王 雪晴
guxiang	顾 湘
chenshi	陈 实
guochao	郭 超
qinzx	秦 照翔
chengmin	程敏
wangyan	王 艳
dengss	邓 思思
wangxj	王 晓娟
lijc	李 进城
sunbin	孙 斌
chris	覃 海峰
panww	潘 薇薇
chenj	陈 骏
lify	李 富耀
wangchc	汪 长城
zhousj	周 斯隽
chengc	程 畅
tony	刘 宇
micah	张 裕斌
lil	李 伦
xiajf	夏 家锋
zhouhf	周 海锋
zhangfq	张 付强
tangsc	唐 善超
liuwp	刘 伟鹏
chenw	陈 顽
xiaq	夏 青
brian	徐 永建
kevin	王 振
leo	蔡 渤
wangxs  王 小诗
